1111111111111111111111
100x1c0x1x0x1x0x1x0c01
1x1c1x1c1c1c1c1c1c1x01
1c1x1c1x1x1x1x1x1x1c01
1x1c1x1c1c1c1c1c1c1x01
1c1x1c1x1x1x1x1x1x1c01
1x1c1x1c1c1c1c1c1c1x01
1c1x1c1x1x1x1x1x1x1c01
1p1c0x1c0c1c0c1c0c1xe1
1111111111111111111111