1111111111111111111111111111
1p0ccccc001111101xxx00000011
100ccccc001111101xxx11111011
100ccccc001111101xxx11111011
100ccccc001111101xxx11111011
100ccccc000000000xxx11111011
100ccccc001111101xxx11111e11
100ccccc001111101xxx11111111
100ccccc001111101xxx11111111
100ccccc001111101xxx11111111
100ccccc00111000111000000111
100ccccc00111000111000000111
100ccccc00000000001001111111
1111111111111111111111111111