1111111111111
1xxxxxxxxpxc1
1x11111111111
1xxxxxxxxxxe1
1111111111111