11111111111111111111111111
10c1xxx1ccc1x0011111111111
10c1x1x1ccc1x1011111111111
1xc1x1x1ccc1x1011111111111
1px1x1x1ccc1x10000000000e1
1xc1x1x1ccc1x1111111111111
10cxx1xxcccxx1111111111111
11111111111111111111111111