1111111111
111111p111
1111110111
11c1110111
111111e111
1111111111