11111111
1p0c1101
1000e101
11111101
11111111