1111111111
1ccc11p111
1ccc110111
1ccc110111
1ccc11e111
1111111111