111111111111111111
1p00000000c0000001
11c110000011111101
11c1110000100ccc01
1110000000100ccc01
100c00000011111101
111111111000c00001
1e0000000001111101
111111111101111101
111111111101111101
11000c111101111101
11000c111101111101
11000c111101111101
11000c000000000001
111111111111111111
