111111111111111111111111
10x00000xxp0011100000011
1x00cxxc00x1011x00000011
1cx11111111101000000cc11
11000000000101110x11cc11
11111111010101100011cc11
1exx0000000101110011cc11
10c00xc111110110x011cc11
1111011111c001110011cc11
1c110000000101100010cc11
10111111110101000x100011
10cx0cx0cx0cx00000100011
111111111111111111111111