1111111111111
100000000pcx1
1111e11111111
1111111111111