11111111111111111111111111
1000000000000p000000000001
10000000000e11111111111111
11111111101111111111111111
1000001110111111111111xc01
10000000000000011111000x11
11111111111110000000000001
11111111111111111111111111